{
    "level": 0,
    "grid": [
        "###################",
        "###################",
        "###################",
        "###################",
        "###################",
        "###################",
        "##########...######",
        "##########.#c######",
        "##########...x#####",
        "######p.c....x#####",
        "###################",
        "###################",
        "###################",
        "###################",
        "###################",
        "###################",
        "###################",
    ]
}
