{
    "level": 1,
    "grid": [
        "###################",
        "###################",
        "###################",
        "#####...###########",
        "#####...###########",
        "#####...###########",
        "###......##########",
        "###.#.##.##########",
        "#...#.##.#####..xx#",
        "#...............xx#",
        "#####.###.#.##..xx#",
        "#####.....#########",
        "###################",
        "###################",
        "###################",
        "###################",
        "###################",
    ],
    "crates": [
        { "x": 5, "y": 4},
        { "x": 7, "y": 5},
        { "x": 7, "y": 6},
        { "x": 5, "y": 6},
        { "x": 5, "y": 9},
        { "x": 2, "y": 9},
    ],
    "player": { "x": 11, "y": 10 }
}
