{
    "level": 1,
    "grid": [
        "###################",
        "###################",
        "###################",
        "#####...###########",
        "#####c..###########",
        "#####..c###########",
        "###..c.c.##########",
        "###.#.##.##########",
        "#...#.##.#####..xx#",
        "#.c..c..........xx#",
        "#####.###.#p##..xx#",
        "#####.....#########",
        "###################",
        "###################",
        "###################",
        "###################",
        "###################",
    ]
}
