{
	"level": 10,
	"grid": [
		"###################",
		"##p####.......#...#",
		"#.cc...cc..c.c.xxx#",
		"#..ccc#....c..#xxx#",
		"#.c...#.cc.cc.#xxx#",
		"###...#..c....#xxx#",
		"#.....#.c.c.c.#xxx#",
		"#....######.###xxx#",
		"##.#..#..c.c..#xxx#",
		"#..##.#.cc.c.c##xx#",
		"#.xx#.#..c......#x#",
		"#.xx#.#.ccc.ccc.#x#",
		"#####.#.......#.#x#",
		"#####.#########.#x#",
		"#####...........#x#",
		"###################",
		"###################"
	]
}
