{
	"level": 11,
	"grid": [
		"###################",
		"###################",
		"###########..######",
		"######.p###c.######",
		"####......c..######",
		"###..c.cc##.#######",
		"##..#c##.....######",
		"##.#.c.cc.#.#######",
		"##...c.#..#.c.#####",
		"####....#..cc.#...#",
		"####.##.c.........#",
		"#x....###..########",
		"#xx.xx#############",
		"#xxx#x#############",
		"#xxxxx#############",
		"###################",
		"###################"
	]
}
