{
    "level": 12,
    "grid": [
        "###################",
        "###################",
        "##..............###",
        "##.#.######.....###",
        "##.#..c.c.c.c#..###",
        "##.#...c.pc..##.###",
        "##.#..c.c.c###xxx##",
        "##.#...c.c..##xxx##",
        "##.###ccc.c.##xxx##",
        "##.....#.##.##xxx##",
        "######...##.##xxx##",
        "##########.....####",
        "##########.....####",
        "###################",
        "###################",
        "###################",
        "###################",
    ]
}
