{
	"level": 13,
	"grid": [
		"###################",
		"###################",
		"###################",
		"####...##..########",
		"###.....#..#....###",
		"#..c.#c.#..#..xxx.#",
		"#.#.c#pc##.#.#x#x.#",
		"#..#.#c..#....x.x.#",
		"#.c....c.#.#.#x#x.#",
		"#...##..##c.c.x.x.#",
		"#.c.#...#..#c#x#x.#",
		"##.c..c...c..cxxx.#",
		"##c.######....##..#",
		"##..###############",
		"###################",
		"###################",
		"###################"
	]
}
