{
    "level": 2,
    "grid": [
        "###################",
        "###################",
        "###################",
        "###################",
        "####xx..#.....#####",
        "####xx..#.c..c..###",
        "####xx..#c####..###",
        "####xx....p.##..###",
        "####xx..#.#..c.####",
        "#########.##c.c.###",
        "######.c..c.c.c.###",
        "######....#.....###",
        "###################",
        "###################",
        "###################",
        "###################",
        "###################",  
    ]
}
