{
    "level": 3,
    "grid": [
        "###################",
        "###################",
        "###################",
        "###################",
        "##########.....p###",
        "##########.c#c.####",
        "##########.c..c####",
        "###########c.c.####",
        "##########.c.#.####",
        "##xxxx..##.c..c..##",
        "###xxx....c..c...##",
        "##xxxx..###########",
        "###################",
        "###################",
        "###################",
        "###################",
        "###################",
    ]
}
