{
    "level": 4,
    "grid": [
        "###################",
        "###################",
        "############..xxxx#",
        "############..xxxx#",
        "#....#..c.c...xxxx#",
        "#.ccc#c..c.#..xxxx#",
        "#..c.....c.#..xxxx#",
        "#.cc.#c.c.c########",
        "#..c.#.....########",
        "##.################",
        "#....#....#########",
        "#....#....#########",
        "#.....c...#########",
        "#..cc#cc..p########",
        "#....#....#########",
        "###################",
        "###################",
    ]
}
