{
	"level": 5,
	"grid": [
		"###################",
		"###################",
		"###################",
		"##########...######",
		"##########.#c##..##",
		"##########.....c.##",
		"##########.###...##",
		"##xxxx..##.c..c####",
		"##xxxx....c.cc.####",
		"##xxxx..##c..c..###",
		"##########..c.p####",
		"##########.c.c..###",
		"############.##.###",
		"############....###",
		"###################",
		"###################",
		"###################"
	]
}
