{
    "level": 6,
    "grid": [
        "###################",
        "###################",
        "###################",
        "###################",
        "####xx..####p######",
        "####xx..###...#####",
        "####xx.....cc.#####",
        "####xx..#.#.c.#####",
        "####xx###.#.c.#####",
        "#######.c.#c..#####",
        "#######..c#.c.#####",
        "#######.c..c..#####",
        "#######..##...#####",
        "###################",
        "###################",
        "###################",
        "###################",
    ]
}
