{
	"level": 7,
	"grid": [
		"###################",
		"###################",
		"###################",
		"###########...#####",
		"#####.#.p##.cc.####",
		"####....c......####",
		"####..c..###...####",
		"######.#####c######",
		"####.c..###.xx#####",
		"####.c.c.c.xxx#####",
		"####....###xxx#####",
		"####.cc.###xxx#####",
		"####..#############",
		"###################",
		"###################",
		"###################",
		"###################"
	]
}
