{
    "level": 8,
    "grid": [
        "###################",
        "####..#############",
        "####....c...c.c.###",
        "####.c#.c.#..c..###",
        "####..c.c..#....###",
        "####.c#.#..####.###",
        "##p#c.c.c..##...###",
        "##....c.#c#...#.###",
        "##...c....c.c.c.###",
        "######..###########",
        "####......#########",
        "####......#########",
        "####xxxxxx#########",
        "####xxxxxx#########",
        "####xxxxxx#########",
        "###################",
        "###################",
    ]
}
