{
	"level": 9,
	"grid": [
		"###################",
		"###################",
		"############..xxx##",
		"############..xxx##",
		"########......x.x##",
		"########..##..xxx##",
		"#########.##..xxx##",
		"#########.#########",
		"#######.ccc.#######",
		"#######..c.c.######",
		"###...#c.c...#...##",
		"##p.c..c....c..c.##",
		"#######.cc.c.######",
		"#######......######",
		"###################",
		"###################",
		"###################"
	]
}
