{
    "grid": [
        "###################",
        "###################",
        "###################",
        "###################",
        "####xx..#.....#####",
        "####xx..#.......###",
        "####xx..#.####..###",
        "####xx......##..###",
        "####xx..#.#....####",
        "#########.##....###",
        "######..........###",
        "######....#.....###",
        "###################",
        "###################",
        "###################",
        "###################",
        "###################",  
    ],
    "crates": [
        { "x": 9, "y": 6},
        { "x": 10, "y": 5},
        { "x": 13, "y": 5},
        { "x": 7, "y": 10},
        { "x": 10, "y": 10},
        { "x": 12, "y": 10},
        { "x": 14, "y": 10},
        { "x": 14, "y": 9},
        { "x": 12, "y": 9},
        { "x": 13, "y": 8},
    ],
    "player": { "x": 10, "y": 7 }
}
